111111
1101P1
1E0X01
110011
100001
111111
111111