11111111111111111111111111111
10000000CCCC00000111001000001
100000000000001001100000P0001
10000E00000000000000CCC000001
1000C001110001110100000000001
10000000000000000000000000001
10000111110000000000000000001
10000000000000000000000010011
100001111100011101000C0000001
10000000000000000C00000000001
11111111111111111111111111111
